"X","CodIstat","Comune","Anno","Total","Male","Female"
1,58001,"Affile",2002,1635,796,839
2,58001,"Affile",2003,1642,797,845
3,58001,"Affile",2004,1635,791,844
4,58001,"Affile",2005,1631,784,847
5,58001,"Affile",2006,1624,777,847
6,58001,"Affile",2007,1614,778,836
7,58001,"Affile",2008,1594,768,826
8,58001,"Affile",2009,1597,766,831
9,58001,"Affile",2010,1583,763,820
10,58001,"Affile",2011,1562,750,812
11,58002,"Agosta",2002,1617,784,833
12,58002,"Agosta",2003,1591,771,820
13,58002,"Agosta",2004,1639,801,838
14,58002,"Agosta",2005,1649,805,844
15,58002,"Agosta",2006,1667,816,851
16,58002,"Agosta",2007,1671,819,852
17,58002,"Agosta",2008,1710,841,869
18,58002,"Agosta",2009,1742,854,888
19,58002,"Agosta",2010,1739,849,890
20,58002,"Agosta",2011,1768,862,906
21,58003,"Albano Laziale",2002,33822,16260,17562
22,58003,"Albano Laziale",2003,34332,16483,17849
23,58003,"Albano Laziale",2004,34806,16759,18047
24,58003,"Albano Laziale",2005,36022,17328,18694
25,58003,"Albano Laziale",2006,37508,18043,19465
26,58003,"Albano Laziale",2007,38215,18404,19811
27,58003,"Albano Laziale",2008,38986,18796,20190
28,58003,"Albano Laziale",2009,38997,18799,20198
29,58003,"Albano Laziale",2010,39770,19167,20603
30,58003,"Albano Laziale",2011,40516,19519,20997
31,58004,"Allumiere",2002,4179,2048,2131
32,58004,"Allumiere",2003,4171,2060,2111
33,58004,"Allumiere",2004,4179,2056,2123
34,58004,"Allumiere",2005,4186,2057,2129
35,58004,"Allumiere",2006,4219,2067,2152
36,58004,"Allumiere",2007,4162,2046,2116
37,58004,"Allumiere",2008,4210,2075,2135
38,58004,"Allumiere",2009,4293,2130,2163
39,58004,"Allumiere",2010,4285,2126,2159
40,58004,"Allumiere",2011,4268,2117,2151
41,58005,"Anguillara Sabazia",2002,14253,6997,7256
42,58005,"Anguillara Sabazia",2003,14777,7267,7510
43,58005,"Anguillara Sabazia",2004,15848,7810,8038
44,58005,"Anguillara Sabazia",2005,16273,8014,8259
45,58005,"Anguillara Sabazia",2006,16807,8265,8542
46,58005,"Anguillara Sabazia",2007,17102,8455,8647
47,58005,"Anguillara Sabazia",2008,17512,8635,8877
48,58005,"Anguillara Sabazia",2009,18256,9002,9254
49,58005,"Anguillara Sabazia",2010,18613,9191,9422
50,58005,"Anguillara Sabazia",2011,18882,9341,9541
51,58006,"Anticoli Corrado",2002,911,452,459
52,58006,"Anticoli Corrado",2003,901,450,451
53,58006,"Anticoli Corrado",2004,919,453,466
54,58006,"Anticoli Corrado",2005,932,461,471
55,58006,"Anticoli Corrado",2006,949,467,482
56,58006,"Anticoli Corrado",2007,932,458,474
57,58006,"Anticoli Corrado",2008,926,458,468
58,58006,"Anticoli Corrado",2009,974,483,491
59,58006,"Anticoli Corrado",2010,977,490,487
60,58006,"Anticoli Corrado",2011,969,480,489
61,58007,"Anzio",2002,37293,17994,19299
62,58007,"Anzio",2003,38353,18542,19811
63,58007,"Anzio",2004,39508,19144,20364
64,58007,"Anzio",2005,46074,22504,23570
65,58007,"Anzio",2006,47358,23213,24145
66,58007,"Anzio",2007,48484,23749,24735
67,58007,"Anzio",2008,49579,24314,25265
68,58007,"Anzio",2009,52192,25700,26492
69,58007,"Anzio",2010,53924,26661,27263
70,58007,"Anzio",2011,55413,27466,27947
71,58008,"Arcinazzo Romano",2002,1330,650,680
72,58008,"Arcinazzo Romano",2003,1385,685,700
73,58008,"Arcinazzo Romano",2004,1405,693,712
74,58008,"Arcinazzo Romano",2005,1416,708,708
75,58008,"Arcinazzo Romano",2006,1446,720,726
76,58008,"Arcinazzo Romano",2007,1464,727,737
77,58008,"Arcinazzo Romano",2008,1474,732,742
78,58008,"Arcinazzo Romano",2009,1498,749,749
79,58008,"Arcinazzo Romano",2010,1491,742,749
80,58008,"Arcinazzo Romano",2011,1466,731,735
81,58117,"Ardea",2002,27420,13550,13870
82,58117,"Ardea",2003,29012,14323,14689
83,58117,"Ardea",2004,30472,15117,15355
84,58117,"Ardea",2005,33195,16540,16655
85,58117,"Ardea",2006,35263,17607,17656
86,58117,"Ardea",2007,36846,18442,18404
87,58117,"Ardea",2008,39170,19561,19609
88,58117,"Ardea",2009,41077,20502,20575
89,58117,"Ardea",2010,41953,20953,21000
90,58117,"Ardea",2011,42879,21439,21440
91,58009,"Ariccia",2002,17848,8771,9077
92,58009,"Ariccia",2003,17669,8667,9002
93,58009,"Ariccia",2004,17885,8764,9121
94,58009,"Ariccia",2005,17995,8852,9143
95,58009,"Ariccia",2006,18053,8842,9211
96,58009,"Ariccia",2007,18060,8829,9231
97,58009,"Ariccia",2008,18083,8823,9260
98,58009,"Ariccia",2009,18283,8935,9348
99,58009,"Ariccia",2010,18410,9038,9372
100,58009,"Ariccia",2011,18555,9095,9460
101,58010,"Arsoli",2002,1538,723,815
102,58010,"Arsoli",2003,1541,725,816
103,58010,"Arsoli",2004,1545,736,809
104,58010,"Arsoli",2005,1558,748,810
105,58010,"Arsoli",2006,1567,756,811
106,58010,"Arsoli",2007,1598,773,825
107,58010,"Arsoli",2008,1657,800,857
108,58010,"Arsoli",2009,1692,820,872
109,58010,"Arsoli",2010,1680,812,868
110,58010,"Arsoli",2011,1670,794,876
111,58011,"Artena",2002,11866,5897,5969
112,58011,"Artena",2003,11981,5945,6036
113,58011,"Artena",2004,12205,6076,6129
114,58011,"Artena",2005,12419,6218,6201
115,58011,"Artena",2006,12674,6316,6358
116,58011,"Artena",2007,12860,6406,6454
117,58011,"Artena",2008,13242,6590,6652
118,58011,"Artena",2009,13526,6738,6788
119,58011,"Artena",2010,13763,6863,6900
120,58011,"Artena",2011,13959,6964,6995
121,58012,"Bellegra",2002,3026,1473,1553
122,58012,"Bellegra",2003,3004,1452,1552
123,58012,"Bellegra",2004,3013,1451,1562
124,58012,"Bellegra",2005,3025,1457,1568
125,58012,"Bellegra",2006,3020,1459,1561
126,58012,"Bellegra",2007,3020,1465,1555
127,58012,"Bellegra",2008,3038,1473,1565
128,58012,"Bellegra",2009,3045,1476,1569
129,58012,"Bellegra",2010,3026,1465,1561
130,58012,"Bellegra",2011,3008,1456,1552
131,58013,"Bracciano",2002,13602,6643,6959
132,58013,"Bracciano",2003,14195,6958,7237
133,58013,"Bracciano",2004,14983,7348,7635
134,58013,"Bracciano",2005,15509,7570,7939
135,58013,"Bracciano",2006,16039,7807,8232
136,58013,"Bracciano",2007,16635,8118,8517
137,58013,"Bracciano",2008,17474,8497,8977
138,58013,"Bracciano",2009,18159,8806,9353
139,58013,"Bracciano",2010,18594,9009,9585
140,58013,"Bracciano",2011,18889,9112,9777
141,58014,"Camerata Nuova",2002,481,239,242
142,58014,"Camerata Nuova",2003,493,246,247
143,58014,"Camerata Nuova",2004,481,239,242
144,58014,"Camerata Nuova",2005,483,242,241
145,58014,"Camerata Nuova",2006,485,249,236
146,58014,"Camerata Nuova",2007,479,246,233
147,58014,"Camerata Nuova",2008,482,248,234
148,58014,"Camerata Nuova",2009,476,246,230
149,58014,"Camerata Nuova",2010,480,245,235
150,58014,"Camerata Nuova",2011,485,247,238
151,58015,"Campagnano di Roma",2002,8846,4207,4639
152,58015,"Campagnano di Roma",2003,8994,4294,4700
153,58015,"Campagnano di Roma",2004,9387,4485,4902
154,58015,"Campagnano di Roma",2005,9639,4632,5007
155,58015,"Campagnano di Roma",2006,9855,4734,5121
156,58015,"Campagnano di Roma",2007,10038,4810,5228
157,58015,"Campagnano di Roma",2008,10301,4938,5363
158,58015,"Campagnano di Roma",2009,10715,5118,5597
159,58015,"Campagnano di Roma",2010,11023,5249,5774
160,58015,"Campagnano di Roma",2011,11166,5324,5842
161,58016,"Canale Monterano",2002,3331,1624,1707
162,58016,"Canale Monterano",2003,3353,1641,1712
163,58016,"Canale Monterano",2004,3406,1666,1740
164,58016,"Canale Monterano",2005,3470,1700,1770
165,58016,"Canale Monterano",2006,3548,1734,1814
166,58016,"Canale Monterano",2007,3595,1764,1831
167,58016,"Canale Monterano",2008,3701,1809,1892
168,58016,"Canale Monterano",2009,3805,1852,1953
169,58016,"Canale Monterano",2010,3908,1893,2015
170,58016,"Canale Monterano",2011,3966,1903,2063
171,58017,"Canterano",2002,371,181,190
172,58017,"Canterano",2003,364,178,186
173,58017,"Canterano",2004,361,173,188
174,58017,"Canterano",2005,363,175,188
175,58017,"Canterano",2006,363,175,188
176,58017,"Canterano",2007,368,180,188
177,58017,"Canterano",2008,353,178,175
178,58017,"Canterano",2009,355,181,174
179,58017,"Canterano",2010,364,186,178
180,58017,"Canterano",2011,369,188,181
181,58018,"Capena",2002,5839,2875,2964
182,58018,"Capena",2003,6019,2974,3045
183,58018,"Capena",2004,6404,3159,3245
184,58018,"Capena",2005,6706,3345,3361
185,58018,"Capena",2006,7106,3547,3559
186,58018,"Capena",2007,7668,3844,3824
187,58018,"Capena",2008,8207,4113,4094
188,58018,"Capena",2009,8867,4459,4408
189,58018,"Capena",2010,9336,4690,4646
190,58018,"Capena",2011,9709,4891,4818
191,58019,"Capranica Prenestina",2002,329,159,170
192,58019,"Capranica Prenestina",2003,325,164,161
193,58019,"Capranica Prenestina",2004,325,166,159
194,58019,"Capranica Prenestina",2005,328,167,161
195,58019,"Capranica Prenestina",2006,337,172,165
196,58019,"Capranica Prenestina",2007,343,176,167
197,58019,"Capranica Prenestina",2008,347,183,164
198,58019,"Capranica Prenestina",2009,386,199,187
199,58019,"Capranica Prenestina",2010,392,202,190
200,58019,"Capranica Prenestina",2011,375,194,181
201,58020,"Carpineto Romano",2002,4921,2404,2517
202,58020,"Carpineto Romano",2003,4884,2389,2495
203,58020,"Carpineto Romano",2004,4874,2387,2487
204,58020,"Carpineto Romano",2005,4809,2345,2464
205,58020,"Carpineto Romano",2006,4811,2337,2474
206,58020,"Carpineto Romano",2007,4770,2325,2445
207,58020,"Carpineto Romano",2008,4799,2353,2446
208,58020,"Carpineto Romano",2009,4787,2348,2439
209,58020,"Carpineto Romano",2010,4748,2331,2417
210,58020,"Carpineto Romano",2011,4714,2306,2408
211,58021,"Casape",2002,748,360,388
212,58021,"Casape",2003,768,369,399
213,58021,"Casape",2004,788,385,403
214,58021,"Casape",2005,781,380,401
215,58021,"Casape",2006,790,388,402
216,58021,"Casape",2007,784,388,396
217,58021,"Casape",2008,777,389,388
218,58021,"Casape",2009,774,393,381
219,58021,"Casape",2010,774,386,388
220,58021,"Casape",2011,748,366,382
221,58022,"Castel Gandolfo",2002,7925,3776,4149
222,58022,"Castel Gandolfo",2003,8108,3869,4239
223,58022,"Castel Gandolfo",2004,8539,4088,4451
224,58022,"Castel Gandolfo",2005,8592,4123,4469
225,58022,"Castel Gandolfo",2006,8643,4138,4505
226,58022,"Castel Gandolfo",2007,8691,4145,4546
227,58022,"Castel Gandolfo",2008,8706,4146,4560
228,58022,"Castel Gandolfo",2009,8952,4258,4694
229,58022,"Castel Gandolfo",2010,9000,4283,4717
230,58022,"Castel Gandolfo",2011,9037,4298,4739
231,58023,"Castel Madama",2002,6436,3138,3298
232,58023,"Castel Madama",2003,6532,3194,3338
233,58023,"Castel Madama",2004,6695,3294,3401
234,58023,"Castel Madama",2005,7033,3489,3544
235,58023,"Castel Madama",2006,7124,3543,3581
236,58023,"Castel Madama",2007,7160,3558,3602
237,58023,"Castel Madama",2008,7312,3630,3682
238,58023,"Castel Madama",2009,7438,3685,3753
239,58023,"Castel Madama",2010,7540,3737,3803
240,58023,"Castel Madama",2011,7568,3742,3826
241,58025,"Castel San Pietro Romano",2002,744,356,388
242,58025,"Castel San Pietro Romano",2003,727,346,381
243,58025,"Castel San Pietro Romano",2004,761,367,394
244,58025,"Castel San Pietro Romano",2005,776,374,402
245,58025,"Castel San Pietro Romano",2006,780,375,405
246,58025,"Castel San Pietro Romano",2007,792,381,411
247,58025,"Castel San Pietro Romano",2008,834,400,434
248,58025,"Castel San Pietro Romano",2009,822,393,429
249,58025,"Castel San Pietro Romano",2010,847,406,441
250,58025,"Castel San Pietro Romano",2011,859,418,441
251,58024,"Castelnuovo di Porto",2002,7195,3509,3686
252,58024,"Castelnuovo di Porto",2003,7403,3605,3798
253,58024,"Castelnuovo di Porto",2004,7661,3740,3921
254,58024,"Castelnuovo di Porto",2005,7851,3845,4006
255,58024,"Castelnuovo di Porto",2006,8123,4003,4120
256,58024,"Castelnuovo di Porto",2007,8177,4035,4142
257,58024,"Castelnuovo di Porto",2008,8376,4117,4259
258,58024,"Castelnuovo di Porto",2009,8679,4267,4412
259,58024,"Castelnuovo di Porto",2010,8810,4331,4479
260,58024,"Castelnuovo di Porto",2011,8886,4362,4524
261,58026,"Cave",2002,9533,4669,4864
262,58026,"Cave",2003,9676,4741,4935
263,58026,"Cave",2004,9860,4867,4993
264,58026,"Cave",2005,9966,4925,5041
265,58026,"Cave",2006,10023,4958,5065
266,58026,"Cave",2007,10116,4987,5129
267,58026,"Cave",2008,10339,5096,5243
268,58026,"Cave",2009,10606,5247,5359
269,58026,"Cave",2010,10757,5316,5441
270,58026,"Cave",2011,10924,5378,5546
271,58027,"Cerreto Laziale",2002,1060,518,542
272,58027,"Cerreto Laziale",2003,1057,521,536
273,58027,"Cerreto Laziale",2004,1060,531,529
274,58027,"Cerreto Laziale",2005,1077,541,536
275,58027,"Cerreto Laziale",2006,1083,545,538
276,58027,"Cerreto Laziale",2007,1106,556,550
277,58027,"Cerreto Laziale",2008,1147,573,574
278,58027,"Cerreto Laziale",2009,1176,577,599
279,58027,"Cerreto Laziale",2010,1192,587,605
280,58027,"Cerreto Laziale",2011,1206,594,612
281,58028,"Cervara di Roma",2002,480,246,234
282,58028,"Cervara di Roma",2003,477,241,236
283,58028,"Cervara di Roma",2004,460,233,227
284,58028,"Cervara di Roma",2005,465,236,229
285,58028,"Cervara di Roma",2006,454,232,222
286,58028,"Cervara di Roma",2007,464,237,227
287,58028,"Cervara di Roma",2008,487,252,235
288,58028,"Cervara di Roma",2009,498,257,241
289,58028,"Cervara di Roma",2010,486,250,236
290,58028,"Cervara di Roma",2011,502,275,227
291,58029,"Cerveteri",2002,27281,13334,13947
292,58029,"Cerveteri",2003,29373,14431,14942
293,58029,"Cerveteri",2004,31261,15346,15915
294,58029,"Cerveteri",2005,32066,15771,16295
295,58029,"Cerveteri",2006,33039,16240,16799
296,58029,"Cerveteri",2007,33390,16407,16983
297,58029,"Cerveteri",2008,34338,16898,17440
298,58029,"Cerveteri",2009,35355,17360,17995
299,58029,"Cerveteri",2010,35692,17517,18175
300,58029,"Cerveteri",2011,36229,17779,18450
301,58118,"Ciampino",2002,36072,17502,18570
302,58118,"Ciampino",2003,36133,17520,18613
303,58118,"Ciampino",2004,37031,17916,19115
304,58118,"Ciampino",2005,37529,18165,19364
305,58118,"Ciampino",2006,37984,18363,19621
306,58118,"Ciampino",2007,37983,18373,19610
307,58118,"Ciampino",2008,37885,18239,19646
308,58118,"Ciampino",2009,38058,18311,19747
309,58118,"Ciampino",2010,38251,18362,19889
310,58118,"Ciampino",2011,38529,18459,20070
311,58030,"Ciciliano",2002,1159,572,587
312,58030,"Ciciliano",2003,1173,582,591
313,58030,"Ciciliano",2004,1206,601,605
314,58030,"Ciciliano",2005,1257,624,633
315,58030,"Ciciliano",2006,1287,639,648
316,58030,"Ciciliano",2007,1301,652,649
317,58030,"Ciciliano",2008,1387,701,686
318,58030,"Ciciliano",2009,1468,745,723
319,58030,"Ciciliano",2010,1452,735,717
320,58030,"Ciciliano",2011,1459,739,720
321,58031,"Cineto Romano",2002,612,285,327
322,58031,"Cineto Romano",2003,624,293,331
323,58031,"Cineto Romano",2004,639,303,336
324,58031,"Cineto Romano",2005,670,325,345
325,58031,"Cineto Romano",2006,673,324,349
326,58031,"Cineto Romano",2007,660,317,343
327,58031,"Cineto Romano",2008,662,322,340
328,58031,"Cineto Romano",2009,681,339,342
329,58031,"Cineto Romano",2010,679,340,339
330,58031,"Cineto Romano",2011,668,336,332
331,58032,"Civitavecchia",2002,49966,24029,25937
332,58032,"Civitavecchia",2003,50068,24027,26041
333,58032,"Civitavecchia",2004,50333,24146,26187
334,58032,"Civitavecchia",2005,50891,24395,26496
335,58032,"Civitavecchia",2006,51119,24511,26608
336,58032,"Civitavecchia",2007,51375,24607,26768
337,58032,"Civitavecchia",2008,51925,24881,27044
338,58032,"Civitavecchia",2009,52196,24953,27243
339,58032,"Civitavecchia",2010,52204,24967,27237
340,58032,"Civitavecchia",2011,52294,25027,27267
341,58033,"Civitella San Paolo",2002,1564,770,794
342,58033,"Civitella San Paolo",2003,1549,765,784
343,58033,"Civitella San Paolo",2004,1525,757,768
344,58033,"Civitella San Paolo",2005,1557,789,768
345,58033,"Civitella San Paolo",2006,1649,830,819
346,58033,"Civitella San Paolo",2007,1672,837,835
347,58033,"Civitella San Paolo",2008,1730,864,866
348,58033,"Civitella San Paolo",2009,1872,943,929
349,58033,"Civitella San Paolo",2010,1947,978,969
350,58033,"Civitella San Paolo",2011,2009,1020,989
351,58034,"Colleferro",2002,20712,10002,10710
352,58034,"Colleferro",2003,20635,9948,10687
353,58034,"Colleferro",2004,20644,9925,10719
354,58034,"Colleferro",2005,21536,10404,11132
355,58034,"Colleferro",2006,21581,10427,11154
356,58034,"Colleferro",2007,21502,10380,11122
357,58034,"Colleferro",2008,21856,10544,11312
358,58034,"Colleferro",2009,22071,10622,11449
359,58034,"Colleferro",2010,22170,10649,11521
360,58034,"Colleferro",2011,22142,10622,11520
361,58035,"Colonna",2002,3348,1619,1729
362,58035,"Colonna",2003,3377,1629,1748
363,58035,"Colonna",2004,3464,1683,1781
364,58035,"Colonna",2005,3553,1728,1825
365,58035,"Colonna",2006,3543,1714,1829
366,58035,"Colonna",2007,3563,1725,1838
367,58035,"Colonna",2008,3643,1778,1865
368,58035,"Colonna",2009,3809,1865,1944
369,58035,"Colonna",2010,3918,1912,2006
370,58035,"Colonna",2011,4016,1951,2065
371,58036,"Fiano Romano",2002,7956,3926,4030
372,58036,"Fiano Romano",2003,8569,4248,4321
373,58036,"Fiano Romano",2004,9028,4484,4544
374,58036,"Fiano Romano",2005,9656,4805,4851
375,58036,"Fiano Romano",2006,10191,5067,5124
376,58036,"Fiano Romano",2007,10851,5384,5467
377,58036,"Fiano Romano",2008,11645,5800,5845
378,58036,"Fiano Romano",2009,12657,6316,6341
379,58036,"Fiano Romano",2010,13369,6693,6676
380,58036,"Fiano Romano",2011,13978,6999,6979
381,58037,"Filacciano",2002,499,227,272
382,58037,"Filacciano",2003,489,219,270
383,58037,"Filacciano",2004,496,225,271
384,58037,"Filacciano",2005,515,233,282
385,58037,"Filacciano",2006,535,250,285
386,58037,"Filacciano",2007,540,255,285
387,58037,"Filacciano",2008,544,254,290
388,58037,"Filacciano",2009,535,252,283
389,58037,"Filacciano",2010,522,249,273
390,58037,"Filacciano",2011,526,253,273
391,58120,"Fiumicino",2002,50960,25162,25798
392,58120,"Fiumicino",2003,51846,25562,26284
393,58120,"Fiumicino",2004,52998,26138,26860
394,58120,"Fiumicino",2005,56602,28109,28493
395,58120,"Fiumicino",2006,59373,29679,29694
396,58120,"Fiumicino",2007,61145,30531,30614
397,58120,"Fiumicino",2008,63623,31724,31899
398,58120,"Fiumicino",2009,66510,33179,33331
399,58120,"Fiumicino",2010,68668,34223,34445
400,58120,"Fiumicino",2011,70985,35376,35609
401,58122,"Fonte Nuova",2002,22695,11159,11536
402,58122,"Fonte Nuova",2003,23071,11343,11728
403,58122,"Fonte Nuova",2004,23772,11707,12065
404,58122,"Fonte Nuova",2005,24659,12164,12495
405,58122,"Fonte Nuova",2006,25091,12341,12750
406,58122,"Fonte Nuova",2007,25829,12696,13133
407,58122,"Fonte Nuova",2008,26486,12986,13500
408,58122,"Fonte Nuova",2009,27475,13440,14035
409,58122,"Fonte Nuova",2010,28210,13802,14408
410,58122,"Fonte Nuova",2011,28620,13968,14652
411,58038,"Formello",2002,9404,4639,4765
412,58038,"Formello",2003,9681,4789,4892
413,58038,"Formello",2004,10265,5069,5196
414,58038,"Formello",2005,10871,5343,5528
415,58038,"Formello",2006,11173,5476,5697
416,58038,"Formello",2007,11362,5563,5799
417,58038,"Formello",2008,11831,5807,6024
418,58038,"Formello",2009,12138,5946,6192
419,58038,"Formello",2010,12409,6042,6367
420,58038,"Formello",2011,12802,6221,6581
421,58039,"Frascati",2002,19355,9359,9996
422,58039,"Frascati",2003,19492,9414,10078
423,58039,"Frascati",2004,19882,9565,10317
424,58039,"Frascati",2005,20149,9688,10461
425,58039,"Frascati",2006,20350,9758,10592
426,58039,"Frascati",2007,20649,9913,10736
427,58039,"Frascati",2008,20737,9929,10808
428,58039,"Frascati",2009,20931,10031,10900
429,58039,"Frascati",2010,20957,10013,10944
430,58039,"Frascati",2011,21285,10150,11135
431,58040,"Gallicano nel Lazio",2002,4620,2313,2307
432,58040,"Gallicano nel Lazio",2003,4782,2402,2380
433,58040,"Gallicano nel Lazio",2004,4952,2494,2458
434,58040,"Gallicano nel Lazio",2005,5179,2615,2564
435,58040,"Gallicano nel Lazio",2006,5294,2681,2613
436,58040,"Gallicano nel Lazio",2007,5361,2726,2635
437,58040,"Gallicano nel Lazio",2008,5638,2859,2779
438,58040,"Gallicano nel Lazio",2009,5837,2974,2863
439,58040,"Gallicano nel Lazio",2010,5958,3031,2927
440,58040,"Gallicano nel Lazio",2011,6058,3063,2995
441,58041,"Gavignano",2002,1752,874,878
442,58041,"Gavignano",2003,1770,888,882
443,58041,"Gavignano",2004,1799,907,892
444,58041,"Gavignano",2005,1870,950,920
445,58041,"Gavignano",2006,1897,960,937
446,58041,"Gavignano",2007,1922,980,942
447,58041,"Gavignano",2008,1970,996,974
448,58041,"Gavignano",2009,1976,994,982
449,58041,"Gavignano",2010,1999,1004,995
450,58041,"Gavignano",2011,1987,1003,984
451,58042,"Genazzano",2002,5327,2624,2703
452,58042,"Genazzano",2003,5342,2630,2712
453,58042,"Genazzano",2004,5470,2699,2771
454,58042,"Genazzano",2005,5537,2735,2802
455,58042,"Genazzano",2006,5646,2789,2857
456,58042,"Genazzano",2007,5706,2819,2887
457,58042,"Genazzano",2008,5851,2888,2963
458,58042,"Genazzano",2009,5953,2947,3006
459,58042,"Genazzano",2010,6002,2979,3023
460,58042,"Genazzano",2011,6036,2992,3044
461,58043,"Genzano di Roma",2002,22187,10867,11320
462,58043,"Genzano di Roma",2003,22204,10856,11348
463,58043,"Genzano di Roma",2004,22334,10884,11450
464,58043,"Genzano di Roma",2005,22564,11007,11557
465,58043,"Genzano di Roma",2006,22685,11034,11651
466,58043,"Genzano di Roma",2007,22695,11049,11646
467,58043,"Genzano di Roma",2008,23122,11239,11883
468,58043,"Genzano di Roma",2009,23772,11555,12217
469,58043,"Genzano di Roma",2010,24129,11731,12398
470,58043,"Genzano di Roma",2011,24364,11803,12561
471,58044,"Gerano",2002,1204,596,608
472,58044,"Gerano",2003,1201,598,603
473,58044,"Gerano",2004,1201,599,602
474,58044,"Gerano",2005,1197,594,603
475,58044,"Gerano",2006,1197,585,612
476,58044,"Gerano",2007,1210,599,611
477,58044,"Gerano",2008,1213,602,611
478,58044,"Gerano",2009,1250,620,630
479,58044,"Gerano",2010,1235,612,623
480,58044,"Gerano",2011,1253,628,625
481,58045,"Gorga",2002,761,370,391
482,58045,"Gorga",2003,753,368,385
483,58045,"Gorga",2004,752,367,385
484,58045,"Gorga",2005,779,380,399
485,58045,"Gorga",2006,767,376,391
486,58045,"Gorga",2007,758,369,389
487,58045,"Gorga",2008,788,387,401
488,58045,"Gorga",2009,798,397,401
489,58045,"Gorga",2010,785,391,394
490,58045,"Gorga",2011,778,386,392
491,58046,"Grottaferrata",2002,17670,8322,9348
492,58046,"Grottaferrata",2003,18025,8505,9520
493,58046,"Grottaferrata",2004,19004,8979,10025
494,58046,"Grottaferrata",2005,19606,9227,10379
495,58046,"Grottaferrata",2006,19986,9398,10588
496,58046,"Grottaferrata",2007,20310,9543,10767
497,58046,"Grottaferrata",2008,20555,9628,10927
498,58046,"Grottaferrata",2009,20893,9810,11083
499,58046,"Grottaferrata",2010,20926,9834,11092
500,58046,"Grottaferrata",2011,21039,9888,11151
501,58047,"Guidonia Montecelio",2002,67941,33578,34363
502,58047,"Guidonia Montecelio",2003,69624,34362,35262
503,58047,"Guidonia Montecelio",2004,71354,35254,36100
504,58047,"Guidonia Montecelio",2005,73073,36248,36825
505,58047,"Guidonia Montecelio",2006,75692,37454,38238
506,58047,"Guidonia Montecelio",2007,76770,37985,38785
507,58047,"Guidonia Montecelio",2008,78491,38820,39671
508,58047,"Guidonia Montecelio",2009,81496,40120,41376
509,58047,"Guidonia Montecelio",2010,82752,40780,41972
510,58047,"Guidonia Montecelio",2011,83736,41210,42526
511,58048,"Jenne",2002,496,247,249
512,58048,"Jenne",2003,478,241,237
513,58048,"Jenne",2004,476,238,238
514,58048,"Jenne",2005,460,227,233
515,58048,"Jenne",2006,446,220,226
516,58048,"Jenne",2007,432,210,222
517,58048,"Jenne",2008,433,210,223
518,58048,"Jenne",2009,427,206,221
519,58048,"Jenne",2010,416,197,219
520,58048,"Jenne",2011,407,194,213
521,58049,"Labico",2002,3758,1862,1896
522,58049,"Labico",2003,3978,1978,2000
523,58049,"Labico",2004,4271,2113,2158
524,58049,"Labico",2005,4523,2246,2277
525,58049,"Labico",2006,4763,2356,2407
526,58049,"Labico",2007,5078,2515,2563
527,58049,"Labico",2008,5397,2683,2714
528,58049,"Labico",2009,5721,2858,2863
529,58049,"Labico",2010,5834,2911,2923
530,58049,"Labico",2011,5982,2979,3003
531,58116,"Ladispoli",2002,30447,14823,15624
532,58116,"Ladispoli",2003,32114,15704,16410
533,58116,"Ladispoli",2004,32987,16186,16801
534,58116,"Ladispoli",2005,34482,17029,17453
535,58116,"Ladispoli",2006,35895,17778,18117
536,58116,"Ladispoli",2007,36609,18111,18498
537,58116,"Ladispoli",2008,37964,18779,19185
538,58116,"Ladispoli",2009,39376,19475,19901
539,58116,"Ladispoli",2010,40279,19933,20346
540,58116,"Ladispoli",2011,41035,20314,20721
541,58050,"Lanuvio",2002,9990,4976,5014
542,58050,"Lanuvio",2003,10194,5070,5124
543,58050,"Lanuvio",2004,10540,5271,5269
544,58050,"Lanuvio",2005,10933,5524,5409
545,58050,"Lanuvio",2006,11402,5784,5618
546,58050,"Lanuvio",2007,11704,5925,5779
547,58050,"Lanuvio",2008,12185,6146,6039
548,58050,"Lanuvio",2009,12581,6335,6246
549,58050,"Lanuvio",2010,12894,6486,6408
550,58050,"Lanuvio",2011,13147,6613,6534
551,58115,"Lariano",2002,10379,5103,5276
552,58115,"Lariano",2003,10592,5213,5379
553,58115,"Lariano",2004,10846,5335,5511
554,58115,"Lariano",2005,11060,5477,5583
555,58115,"Lariano",2006,11295,5594,5701
556,58115,"Lariano",2007,11605,5769,5836
557,58115,"Lariano",2008,12009,5953,6056
558,58115,"Lariano",2009,12457,6182,6275
559,58115,"Lariano",2010,12721,6308,6413
560,58115,"Lariano",2011,13011,6442,6569
561,58051,"Licenza",2002,955,464,491
562,58051,"Licenza",2003,954,468,486
563,58051,"Licenza",2004,949,468,481
564,58051,"Licenza",2005,925,465,460
565,58051,"Licenza",2006,942,477,465
566,58051,"Licenza",2007,945,475,470
567,58051,"Licenza",2008,980,500,480
568,58051,"Licenza",2009,1012,519,493
569,58051,"Licenza",2010,1019,520,499
570,58051,"Licenza",2011,1021,530,491
571,58052,"Magliano Romano",2002,1304,665,639
572,58052,"Magliano Romano",2003,1312,657,655
573,58052,"Magliano Romano",2004,1308,657,651
574,58052,"Magliano Romano",2005,1321,664,657
575,58052,"Magliano Romano",2006,1422,707,715
576,58052,"Magliano Romano",2007,1441,727,714
577,58052,"Magliano Romano",2008,1490,743,747
578,58052,"Magliano Romano",2009,1518,767,751
579,58052,"Magliano Romano",2010,1530,773,757
580,58052,"Magliano Romano",2011,1519,762,757
581,58053,"Mandela",2002,770,386,384
582,58053,"Mandela",2003,797,400,397
583,58053,"Mandela",2004,791,394,397
584,58053,"Mandela",2005,826,421,405
585,58053,"Mandela",2006,833,431,402
586,58053,"Mandela",2007,855,445,410
587,58053,"Mandela",2008,900,467,433
588,58053,"Mandela",2009,933,481,452
589,58053,"Mandela",2010,938,485,453
590,58053,"Mandela",2011,947,488,459
591,58054,"Manziana",2002,5855,2796,3059
592,58054,"Manziana",2003,5995,2850,3145
593,58054,"Manziana",2004,6092,2867,3225
594,58054,"Manziana",2005,6148,2906,3242
595,58054,"Manziana",2006,6249,2967,3282
596,58054,"Manziana",2007,6276,2986,3290
597,58054,"Manziana",2008,6398,3042,3356
598,58054,"Manziana",2009,6649,3143,3506
599,58054,"Manziana",2010,6775,3203,3572
600,58054,"Manziana",2011,6951,3284,3667
601,58055,"Marano Equo",2002,770,396,374
602,58055,"Marano Equo",2003,777,400,377
603,58055,"Marano Equo",2004,795,412,383
604,58055,"Marano Equo",2005,795,410,385
605,58055,"Marano Equo",2006,804,414,390
606,58055,"Marano Equo",2007,810,414,396
607,58055,"Marano Equo",2008,795,410,385
608,58055,"Marano Equo",2009,811,421,390
609,58055,"Marano Equo",2010,836,429,407
610,58055,"Marano Equo",2011,825,426,399
611,58056,"Marcellina",2002,5514,2716,2798
612,58056,"Marcellina",2003,5546,2730,2816
613,58056,"Marcellina",2004,5698,2826,2872
614,58056,"Marcellina",2005,5913,2961,2952
615,58056,"Marcellina",2006,6038,3016,3022
616,58056,"Marcellina",2007,6128,3053,3075
617,58056,"Marcellina",2008,6643,3318,3325
618,58056,"Marcellina",2009,6894,3462,3432
619,58056,"Marcellina",2010,7023,3522,3501
620,58056,"Marcellina",2011,7101,3547,3554
621,58057,"Marino",2002,32823,15865,16958
622,58057,"Marino",2003,36035,17460,18575
623,58057,"Marino",2004,36708,17813,18895
624,58057,"Marino",2005,37023,17937,19086
625,58057,"Marino",2006,37575,18169,19406
626,58057,"Marino",2007,37684,18172,19512
627,58057,"Marino",2008,38225,18419,19806
628,58057,"Marino",2009,38769,18679,20090
629,58057,"Marino",2010,39199,18852,20347
630,58057,"Marino",2011,39976,19286,20690
631,58058,"Mazzano Romano",2002,2535,1265,1270
632,58058,"Mazzano Romano",2003,2533,1265,1268
633,58058,"Mazzano Romano",2004,2584,1295,1289
634,58058,"Mazzano Romano",2005,2621,1325,1296
635,58058,"Mazzano Romano",2006,2638,1337,1301
636,58058,"Mazzano Romano",2007,2658,1355,1303
637,58058,"Mazzano Romano",2008,2740,1396,1344
638,58058,"Mazzano Romano",2009,2853,1445,1408
639,58058,"Mazzano Romano",2010,2993,1515,1478
640,58058,"Mazzano Romano",2011,3064,1543,1521
641,58059,"Mentana",2002,16507,8186,8321
642,58059,"Mentana",2003,16967,8422,8545
643,58059,"Mentana",2004,17969,8943,9026
644,58059,"Mentana",2005,18364,9118,9246
645,58059,"Mentana",2006,18879,9368,9511
646,58059,"Mentana",2007,19245,9537,9708
647,58059,"Mentana",2008,19874,9831,10043
648,58059,"Mentana",2009,20550,10125,10425
649,58059,"Mentana",2010,20973,10355,10618
650,58059,"Mentana",2011,21602,10641,10961
651,58064,"Monte Porzio Catone",2002,8243,4000,4243
652,58064,"Monte Porzio Catone",2003,8311,4059,4252
653,58064,"Monte Porzio Catone",2004,8372,4081,4291
654,58064,"Monte Porzio Catone",2005,8546,4157,4389
655,58064,"Monte Porzio Catone",2006,8607,4196,4411
656,58064,"Monte Porzio Catone",2007,8700,4244,4456
657,58064,"Monte Porzio Catone",2008,8737,4274,4463
658,58064,"Monte Porzio Catone",2009,8921,4356,4565
659,58064,"Monte Porzio Catone",2010,8934,4335,4599
660,58064,"Monte Porzio Catone",2011,8989,4337,4652
661,58060,"Montecompatri",2002,8124,3985,4139
662,58060,"Montecompatri",2003,8428,4148,4280
663,58060,"Montecompatri",2004,8785,4339,4446
664,58060,"Montecompatri",2005,8971,4440,4531
665,58060,"Montecompatri",2006,9146,4505,4641
666,58060,"Montecompatri",2007,9324,4612,4712
667,58060,"Montecompatri",2008,9662,4791,4871
668,58060,"Montecompatri",2009,10174,5072,5102
669,58060,"Montecompatri",2010,10424,5178,5246
670,58060,"Montecompatri",2011,10716,5328,5388
671,58061,"Monteflavio",2002,1369,653,716
672,58061,"Monteflavio",2003,1363,650,713
673,58061,"Monteflavio",2004,1393,666,727
674,58061,"Monteflavio",2005,1400,675,725
675,58061,"Monteflavio",2006,1381,665,716
676,58061,"Monteflavio",2007,1387,668,719
677,58061,"Monteflavio",2008,1401,669,732
678,58061,"Monteflavio",2009,1411,670,741
679,58061,"Monteflavio",2010,1433,681,752
680,58061,"Monteflavio",2011,1420,673,747
681,58062,"Montelanico",2002,1916,926,990
682,58062,"Montelanico",2003,1936,936,1000
683,58062,"Montelanico",2004,1961,953,1008
684,58062,"Montelanico",2005,1957,935,1022
685,58062,"Montelanico",2006,1972,943,1029
686,58062,"Montelanico",2007,1989,957,1032
687,58062,"Montelanico",2008,2022,969,1053
688,58062,"Montelanico",2009,2064,995,1069
689,58062,"Montelanico",2010,2103,1014,1089
690,58062,"Montelanico",2011,2156,1042,1114
691,58063,"Montelibretti",2002,4828,2315,2513
692,58063,"Montelibretti",2003,4860,2325,2535
693,58063,"Montelibretti",2004,4871,2333,2538
694,58063,"Montelibretti",2005,4906,2337,2569
695,58063,"Montelibretti",2006,4952,2347,2605
696,58063,"Montelibretti",2007,4976,2356,2620
697,58063,"Montelibretti",2008,5011,2392,2619
698,58063,"Montelibretti",2009,5090,2449,2641
699,58063,"Montelibretti",2010,5142,2481,2661
700,58063,"Montelibretti",2011,5130,2471,2659
701,58065,"Monterotondo",2002,34374,16710,17664
702,58065,"Monterotondo",2003,34856,16955,17901
703,58065,"Monterotondo",2004,35379,17225,18154
704,58065,"Monterotondo",2005,36094,17551,18543
705,58065,"Monterotondo",2006,36751,17809,18942
706,58065,"Monterotondo",2007,37181,17994,19187
707,58065,"Monterotondo",2008,37359,18155,19204
708,58065,"Monterotondo",2009,38612,18789,19823
709,58065,"Monterotondo",2010,39092,19010,20082
710,58065,"Monterotondo",2011,39588,19235,20353
711,58066,"Montorio Romano",2002,1831,909,922
712,58066,"Montorio Romano",2003,1864,920,944
713,58066,"Montorio Romano",2004,1891,938,953
714,58066,"Montorio Romano",2005,1903,952,951
715,58066,"Montorio Romano",2006,1928,966,962
716,58066,"Montorio Romano",2007,1904,957,947
717,58066,"Montorio Romano",2008,1982,998,984
718,58066,"Montorio Romano",2009,1984,1000,984
719,58066,"Montorio Romano",2010,2014,1015,999
720,58066,"Montorio Romano",2011,2035,1027,1008
721,58067,"Moricone",2002,2360,1183,1177
722,58067,"Moricone",2003,2400,1200,1200
723,58067,"Moricone",2004,2434,1215,1219
724,58067,"Moricone",2005,2498,1242,1256
725,58067,"Moricone",2006,2518,1264,1254
726,58067,"Moricone",2007,2545,1269,1276
727,58067,"Moricone",2008,2600,1295,1305
728,58067,"Moricone",2009,2667,1338,1329
729,58067,"Moricone",2010,2693,1360,1333
730,58067,"Moricone",2011,2748,1379,1369
731,58068,"Morlupo",2002,6675,3214,3461
732,58068,"Morlupo",2003,6924,3351,3573
733,58068,"Morlupo",2004,7117,3455,3662
734,58068,"Morlupo",2005,7230,3508,3722
735,58068,"Morlupo",2006,7620,3703,3917
736,58068,"Morlupo",2007,7727,3750,3977
737,58068,"Morlupo",2008,8016,3906,4110
738,58068,"Morlupo",2009,8269,4005,4264
739,58068,"Morlupo",2010,8356,4074,4282
740,58068,"Morlupo",2011,8486,4121,4365
741,58069,"Nazzano",2002,1253,615,638
742,58069,"Nazzano",2003,1252,617,635
743,58069,"Nazzano",2004,1248,623,625
744,58069,"Nazzano",2005,1279,633,646
745,58069,"Nazzano",2006,1297,642,655
746,58069,"Nazzano",2007,1300,650,650
747,58069,"Nazzano",2008,1344,672,672
748,58069,"Nazzano",2009,1350,675,675
749,58069,"Nazzano",2010,1353,677,676
750,58069,"Nazzano",2011,1368,680,688
751,58070,"Nemi",2002,1722,846,876
752,58070,"Nemi",2003,1854,909,945
753,58070,"Nemi",2004,1892,928,964
754,58070,"Nemi",2005,1923,946,977
755,58070,"Nemi",2006,1922,935,987
756,58070,"Nemi",2007,1934,942,992
757,58070,"Nemi",2008,1950,939,1011
758,58070,"Nemi",2009,1978,958,1020
759,58070,"Nemi",2010,2005,978,1027
760,58070,"Nemi",2011,2026,988,1038
761,58071,"Nerola",2002,1407,674,733
762,58071,"Nerola",2003,1430,689,741
763,58071,"Nerola",2004,1448,706,742
764,58071,"Nerola",2005,1503,739,764
765,58071,"Nerola",2006,1579,780,799
766,58071,"Nerola",2007,1611,800,811
767,58071,"Nerola",2008,1654,821,833
768,58071,"Nerola",2009,1704,849,855
769,58071,"Nerola",2010,1748,870,878
770,58071,"Nerola",2011,1811,901,910
771,58072,"Nettuno",2002,36254,17456,18798
772,58072,"Nettuno",2003,36849,17719,19130
773,58072,"Nettuno",2004,39434,18919,20515
774,58072,"Nettuno",2005,40651,19574,21077
775,58072,"Nettuno",2006,41867,20099,21768
776,58072,"Nettuno",2007,42370,20286,22084
777,58072,"Nettuno",2008,43409,20791,22618
778,58072,"Nettuno",2009,44444,21254,23190
779,58072,"Nettuno",2010,46847,22409,24438
780,58072,"Nettuno",2011,47332,22661,24671
781,58073,"Olevano Romano",2002,6393,3155,3238
782,58073,"Olevano Romano",2003,6401,3168,3233
783,58073,"Olevano Romano",2004,6475,3232,3243
784,58073,"Olevano Romano",2005,6518,3254,3264
785,58073,"Olevano Romano",2006,6593,3277,3316
786,58073,"Olevano Romano",2007,6616,3280,3336
787,58073,"Olevano Romano",2008,6814,3387,3427
788,58073,"Olevano Romano",2009,6881,3421,3460
789,58073,"Olevano Romano",2010,6907,3440,3467
790,58073,"Olevano Romano",2011,6914,3430,3484
791,58074,"Palestrina",2002,17221,8447,8774
792,58074,"Palestrina",2003,17367,8505,8862
793,58074,"Palestrina",2004,17783,8710,9073
794,58074,"Palestrina",2005,18012,8832,9180
795,58074,"Palestrina",2006,18334,8992,9342
796,58074,"Palestrina",2007,18663,9115,9548
797,58074,"Palestrina",2008,19251,9424,9827
798,58074,"Palestrina",2009,20894,10394,10500
799,58074,"Palestrina",2010,21334,10634,10700
800,58074,"Palestrina",2011,21602,10740,10862
801,58075,"Palombara Sabina",2002,10698,5308,5390
802,58075,"Palombara Sabina",2003,10868,5405,5463
803,58075,"Palombara Sabina",2004,10971,5442,5529
804,58075,"Palombara Sabina",2005,11186,5554,5632
805,58075,"Palombara Sabina",2006,11482,5702,5780
806,58075,"Palombara Sabina",2007,11778,5859,5919
807,58075,"Palombara Sabina",2008,12189,6058,6131
808,58075,"Palombara Sabina",2009,12577,6262,6315
809,58075,"Palombara Sabina",2010,12814,6385,6429
810,58075,"Palombara Sabina",2011,12991,6485,6506
811,58076,"Percile",2002,215,109,106
812,58076,"Percile",2003,215,108,107
813,58076,"Percile",2004,218,113,105
814,58076,"Percile",2005,218,113,105
815,58076,"Percile",2006,217,111,106
816,58076,"Percile",2007,211,107,104
817,58076,"Percile",2008,222,109,113
818,58076,"Percile",2009,232,115,117
819,58076,"Percile",2010,232,117,115
820,58076,"Percile",2011,238,120,118
821,58077,"Pisoniano",2002,728,348,380
822,58077,"Pisoniano",2003,726,348,378
823,58077,"Pisoniano",2004,728,349,379
824,58077,"Pisoniano",2005,741,352,389
825,58077,"Pisoniano",2006,744,355,389
826,58077,"Pisoniano",2007,727,342,385
827,58077,"Pisoniano",2008,762,367,395
828,58077,"Pisoniano",2009,808,391,417
829,58077,"Pisoniano",2010,807,388,419
830,58077,"Pisoniano",2011,829,408,421
831,58078,"Poli",2002,2159,1043,1116
832,58078,"Poli",2003,2166,1048,1118
833,58078,"Poli",2004,2211,1075,1136
834,58078,"Poli",2005,2291,1107,1184
835,58078,"Poli",2006,2299,1116,1183
836,58078,"Poli",2007,2288,1104,1184
837,58078,"Poli",2008,2419,1173,1246
838,58078,"Poli",2009,2469,1206,1263
839,58078,"Poli",2010,2458,1209,1249
840,58078,"Poli",2011,2479,1219,1260
841,58079,"Pomezia",2002,43936,21644,22292
842,58079,"Pomezia",2003,43919,21654,22265
843,58079,"Pomezia",2004,45403,22364,23039
844,58079,"Pomezia",2005,46802,23068,23734
845,58079,"Pomezia",2006,48385,23854,24531
846,58079,"Pomezia",2007,52571,26052,26519
847,58079,"Pomezia",2008,56105,27912,28193
848,58079,"Pomezia",2009,58621,29228,29393
849,58079,"Pomezia",2010,60167,29986,30181
850,58079,"Pomezia",2011,61106,30396,30710
851,58080,"Ponzano Romano",2002,1036,536,500
852,58080,"Ponzano Romano",2003,1026,533,493
853,58080,"Ponzano Romano",2004,1084,576,508
854,58080,"Ponzano Romano",2005,1061,560,501
855,58080,"Ponzano Romano",2006,1062,552,510
856,58080,"Ponzano Romano",2007,1105,582,523
857,58080,"Ponzano Romano",2008,1163,619,544
858,58080,"Ponzano Romano",2009,1178,612,566
859,58080,"Ponzano Romano",2010,1161,600,561
860,58080,"Ponzano Romano",2011,1183,616,567
861,58081,"Riano",2002,6502,3253,3249
862,58081,"Riano",2003,6658,3326,3332
863,58081,"Riano",2004,6918,3470,3448
864,58081,"Riano",2005,7185,3581,3604
865,58081,"Riano",2006,7546,3770,3776
866,58081,"Riano",2007,7915,3949,3966
867,58081,"Riano",2008,8333,4161,4172
868,58081,"Riano",2009,9082,4564,4518
869,58081,"Riano",2010,9411,4709,4702
870,58081,"Riano",2011,9902,4960,4942
871,58082,"Rignano Flaminio",2002,6886,3384,3502
872,58082,"Rignano Flaminio",2003,7096,3470,3626
873,58082,"Rignano Flaminio",2004,7422,3647,3775
874,58082,"Rignano Flaminio",2005,7714,3780,3934
875,58082,"Rignano Flaminio",2006,7999,3913,4086
876,58082,"Rignano Flaminio",2007,8346,4090,4256
877,58082,"Rignano Flaminio",2008,8712,4278,4434
878,58082,"Rignano Flaminio",2009,9110,4474,4636
879,58082,"Rignano Flaminio",2010,9370,4597,4773
880,58082,"Rignano Flaminio",2011,9740,4790,4950
881,58083,"Riofreddo",2002,771,380,391
882,58083,"Riofreddo",2003,763,372,391
883,58083,"Riofreddo",2004,762,369,393
884,58083,"Riofreddo",2005,757,371,386
885,58083,"Riofreddo",2006,750,362,388
886,58083,"Riofreddo",2007,752,369,383
887,58083,"Riofreddo",2008,772,377,395
888,58083,"Riofreddo",2009,776,375,401
889,58083,"Riofreddo",2010,777,377,400
890,58083,"Riofreddo",2011,790,381,409
891,58084,"Rocca Canterano",2002,250,137,113
892,58084,"Rocca Canterano",2003,249,136,113
893,58084,"Rocca Canterano",2004,239,131,108
894,58084,"Rocca Canterano",2005,230,125,105
895,58084,"Rocca Canterano",2006,223,120,103
896,58084,"Rocca Canterano",2007,222,120,102
897,58084,"Rocca Canterano",2008,221,118,103
898,58084,"Rocca Canterano",2009,216,116,100
899,58084,"Rocca Canterano",2010,213,113,100
900,58084,"Rocca Canterano",2011,202,106,96
901,58085,"Rocca di Cave",2002,357,178,179
902,58085,"Rocca di Cave",2003,348,174,174
903,58085,"Rocca di Cave",2004,377,192,185
904,58085,"Rocca di Cave",2005,386,202,184
905,58085,"Rocca di Cave",2006,386,202,184
906,58085,"Rocca di Cave",2007,380,200,180
907,58085,"Rocca di Cave",2008,386,204,182
908,58085,"Rocca di Cave",2009,381,200,181
909,58085,"Rocca di Cave",2010,392,205,187
910,58085,"Rocca di Cave",2011,385,200,185
911,58086,"Rocca di Papa",2002,13179,6519,6660
912,58086,"Rocca di Papa",2003,13257,6522,6735
913,58086,"Rocca di Papa",2004,13665,6775,6890
914,58086,"Rocca di Papa",2005,13914,6899,7015
915,58086,"Rocca di Papa",2006,14204,7034,7170
916,58086,"Rocca di Papa",2007,14445,7126,7319
917,58086,"Rocca di Papa",2008,14859,7328,7531
918,58086,"Rocca di Papa",2009,15307,7589,7718
919,58086,"Rocca di Papa",2010,15772,7830,7942
920,58086,"Rocca di Papa",2011,16149,8034,8115
921,58088,"Rocca Priora",2002,10069,5019,5050
922,58088,"Rocca Priora",2003,10674,5346,5328
923,58088,"Rocca Priora",2004,10764,5379,5385
924,58088,"Rocca Priora",2005,10751,5397,5354
925,58088,"Rocca Priora",2006,10943,5504,5439
926,58088,"Rocca Priora",2007,11208,5649,5559
927,58088,"Rocca Priora",2008,11490,5817,5673
928,58088,"Rocca Priora",2009,11742,5928,5814
929,58088,"Rocca Priora",2010,11873,5987,5886
930,58088,"Rocca Priora",2011,11987,6001,5986
931,58089,"Rocca Santo Stefano",2002,1009,521,488
932,58089,"Rocca Santo Stefano",2003,997,514,483
933,58089,"Rocca Santo Stefano",2004,987,509,478
934,58089,"Rocca Santo Stefano",2005,983,496,487
935,58089,"Rocca Santo Stefano",2006,985,500,485
936,58089,"Rocca Santo Stefano",2007,995,506,489
937,58089,"Rocca Santo Stefano",2008,1014,524,490
938,58089,"Rocca Santo Stefano",2009,1042,540,502
939,58089,"Rocca Santo Stefano",2010,1040,541,499
940,58089,"Rocca Santo Stefano",2011,1040,539,501
941,58087,"Roccagiovine",2002,298,141,157
942,58087,"Roccagiovine",2003,296,142,154
943,58087,"Roccagiovine",2004,294,144,150
944,58087,"Roccagiovine",2005,301,150,151
945,58087,"Roccagiovine",2006,298,148,150
946,58087,"Roccagiovine",2007,297,148,149
947,58087,"Roccagiovine",2008,292,143,149
948,58087,"Roccagiovine",2009,295,144,151
949,58087,"Roccagiovine",2010,288,141,147
950,58087,"Roccagiovine",2011,290,140,150
951,58090,"Roiate",2002,804,386,418
952,58090,"Roiate",2003,800,387,413
953,58090,"Roiate",2004,788,387,401
954,58090,"Roiate",2005,781,383,398
955,58090,"Roiate",2006,792,387,405
956,58090,"Roiate",2007,777,380,397
957,58090,"Roiate",2008,776,381,395
958,58090,"Roiate",2009,779,382,397
959,58090,"Roiate",2010,769,376,393
960,58090,"Roiate",2011,770,379,391
961,58091,"Roma",2002,2545860,1198645,1347215
962,58091,"Roma",2003,2540829,1194818,1346011
963,58091,"Roma",2004,2542003,1192349,1349654
964,58091,"Roma",2005,2553873,1197120,1356753
965,58091,"Roma",2006,2547677,1192999,1354678
966,58091,"Roma",2007,2705603,1276295,1429308
967,58091,"Roma",2008,2718768,1281482,1437286
968,58091,"Roma",2009,2724347,1283145,1441202
969,58091,"Roma",2010,2743796,1292907,1450889
970,58091,"Roma",2011,2761477,1301763,1459714
971,58092,"Roviano",2002,1382,651,731
972,58092,"Roviano",2003,1366,639,727
973,58092,"Roviano",2004,1384,652,732
974,58092,"Roviano",2005,1379,650,729
975,58092,"Roviano",2006,1414,665,749
976,58092,"Roviano",2007,1421,672,749
977,58092,"Roviano",2008,1431,675,756
978,58092,"Roviano",2009,1445,676,769
979,58092,"Roviano",2010,1436,673,763
980,58092,"Roviano",2011,1429,675,754
981,58093,"Sacrofano",2002,5713,2791,2922
982,58093,"Sacrofano",2003,5858,2857,3001
983,58093,"Sacrofano",2004,6239,3054,3185
984,58093,"Sacrofano",2005,6446,3183,3263
985,58093,"Sacrofano",2006,6700,3303,3397
986,58093,"Sacrofano",2007,6760,3333,3427
987,58093,"Sacrofano",2008,6950,3423,3527
988,58093,"Sacrofano",2009,7288,3597,3691
989,58093,"Sacrofano",2010,7458,3700,3758
990,58093,"Sacrofano",2011,7508,3713,3795
991,58094,"Sambuci",2002,892,435,457
992,58094,"Sambuci",2003,891,439,452
993,58094,"Sambuci",2004,882,440,442
994,58094,"Sambuci",2005,882,438,444
995,58094,"Sambuci",2006,897,446,451
996,58094,"Sambuci",2007,912,454,458
997,58094,"Sambuci",2008,954,475,479
998,58094,"Sambuci",2009,958,479,479
999,58094,"Sambuci",2010,958,470,488
1000,58094,"Sambuci",2011,966,475,491
1001,58119,"San Cesareo",2002,9500,4769,4731
1002,58119,"San Cesareo",2003,9779,4919,4860
1003,58119,"San Cesareo",2004,10545,5300,5245
1004,58119,"San Cesareo",2005,11303,5711,5592
1005,58119,"San Cesareo",2006,11707,5926,5781
1006,58119,"San Cesareo",2007,11988,6077,5911
1007,58119,"San Cesareo",2008,12407,6276,6131
1008,58119,"San Cesareo",2009,13127,6635,6492
1009,58119,"San Cesareo",2010,13675,6884,6791
1010,58119,"San Cesareo",2011,14175,7092,7083
1011,58095,"San Gregorio da Sassola",2002,1442,700,742
1012,58095,"San Gregorio da Sassola",2003,1460,713,747
1013,58095,"San Gregorio da Sassola",2004,1449,706,743
1014,58095,"San Gregorio da Sassola",2005,1466,717,749
1015,58095,"San Gregorio da Sassola",2006,1498,732,766
1016,58095,"San Gregorio da Sassola",2007,1495,737,758
1017,58095,"San Gregorio da Sassola",2008,1527,761,766
1018,58095,"San Gregorio da Sassola",2009,1535,772,763
1019,58095,"San Gregorio da Sassola",2010,1554,774,780
1020,58095,"San Gregorio da Sassola",2011,1578,783,795
1021,58096,"San Polo dei Cavalieri",2002,2343,1190,1153
1022,58096,"San Polo dei Cavalieri",2003,2373,1199,1174
1023,58096,"San Polo dei Cavalieri",2004,2414,1210,1204
1024,58096,"San Polo dei Cavalieri",2005,2443,1225,1218
1025,58096,"San Polo dei Cavalieri",2006,2492,1255,1237
1026,58096,"San Polo dei Cavalieri",2007,2547,1273,1274
1027,58096,"San Polo dei Cavalieri",2008,2655,1330,1325
1028,58096,"San Polo dei Cavalieri",2009,2809,1409,1400
1029,58096,"San Polo dei Cavalieri",2010,2897,1451,1446
1030,58096,"San Polo dei Cavalieri",2011,2973,1489,1484
1031,58100,"San Vito Romano",2002,3276,1586,1690
1032,58100,"San Vito Romano",2003,3281,1592,1689
1033,58100,"San Vito Romano",2004,3282,1595,1687
1034,58100,"San Vito Romano",2005,3312,1606,1706
1035,58100,"San Vito Romano",2006,3346,1608,1738
1036,58100,"San Vito Romano",2007,3357,1621,1736
1037,58100,"San Vito Romano",2008,3469,1669,1800
1038,58100,"San Vito Romano",2009,3474,1672,1802
1039,58100,"San Vito Romano",2010,3456,1676,1780
1040,58100,"San Vito Romano",2011,3429,1669,1760
1041,58097,"Santa Marinella",2002,15032,7156,7876
1042,58097,"Santa Marinella",2003,15518,7365,8153
1043,58097,"Santa Marinella",2004,16376,7846,8530
1044,58097,"Santa Marinella",2005,16311,7838,8473
1045,58097,"Santa Marinella",2006,16727,8059,8668
1046,58097,"Santa Marinella",2007,16956,8189,8767
1047,58097,"Santa Marinella",2008,17354,8357,8997
1048,58097,"Santa Marinella",2009,17820,8613,9207
1049,58097,"Santa Marinella",2010,18088,8705,9383
1050,58097,"Santa Marinella",2011,18397,8856,9541
1051,58098,"Sant'Angelo Romano",2002,3111,1529,1582
1052,58098,"Sant'Angelo Romano",2003,3190,1553,1637
1053,58098,"Sant'Angelo Romano",2004,3345,1640,1705
1054,58098,"Sant'Angelo Romano",2005,3490,1705,1785
1055,58098,"Sant'Angelo Romano",2006,3639,1769,1870
1056,58098,"Sant'Angelo Romano",2007,3809,1854,1955
1057,58098,"Sant'Angelo Romano",2008,4103,2011,2092
1058,58098,"Sant'Angelo Romano",2009,4333,2133,2200
1059,58098,"Sant'Angelo Romano",2010,4542,2254,2288
1060,58098,"Sant'Angelo Romano",2011,4778,2362,2416
1061,58099,"Sant'Oreste",2002,3549,1726,1823
1062,58099,"Sant'Oreste",2003,3568,1741,1827
1063,58099,"Sant'Oreste",2004,3591,1754,1837
1064,58099,"Sant'Oreste",2005,3606,1767,1839
1065,58099,"Sant'Oreste",2006,3625,1764,1861
1066,58099,"Sant'Oreste",2007,3636,1777,1859
1067,58099,"Sant'Oreste",2008,3743,1836,1907
1068,58099,"Sant'Oreste",2009,3810,1880,1930
1069,58099,"Sant'Oreste",2010,3874,1911,1963
1070,58099,"Sant'Oreste",2011,3870,1895,1975
1071,58101,"Saracinesco",2002,176,100,76
1072,58101,"Saracinesco",2003,165,95,70
1073,58101,"Saracinesco",2004,172,99,73
1074,58101,"Saracinesco",2005,169,98,71
1075,58101,"Saracinesco",2006,164,97,67
1076,58101,"Saracinesco",2007,159,95,64
1077,58101,"Saracinesco",2008,169,99,70
1078,58101,"Saracinesco",2009,166,95,71
1079,58101,"Saracinesco",2010,165,95,70
1080,58101,"Saracinesco",2011,169,99,70
1081,58102,"Segni",2002,8798,4293,4505
1082,58102,"Segni",2003,8866,4323,4543
1083,58102,"Segni",2004,9035,4422,4613
1084,58102,"Segni",2005,9129,4493,4636
1085,58102,"Segni",2006,9207,4533,4674
1086,58102,"Segni",2007,9258,4564,4694
1087,58102,"Segni",2008,9332,4591,4741
1088,58102,"Segni",2009,9392,4628,4764
1089,58102,"Segni",2010,9392,4610,4782
1090,58102,"Segni",2011,9439,4627,4812
1091,58103,"Subiaco",2002,9035,4446,4589
1092,58103,"Subiaco",2003,9188,4529,4659
1093,58103,"Subiaco",2004,9179,4538,4641
1094,58103,"Subiaco",2005,9255,4585,4670
1095,58103,"Subiaco",2006,9296,4601,4695
1096,58103,"Subiaco",2007,9269,4570,4699
1097,58103,"Subiaco",2008,9321,4585,4736
1098,58103,"Subiaco",2009,9431,4647,4784
1099,58103,"Subiaco",2010,9391,4605,4786
1100,58103,"Subiaco",2011,9406,4605,4801
1101,58104,"Tivoli",2002,49260,23793,25467
1102,58104,"Tivoli",2003,49254,23743,25511
1103,58104,"Tivoli",2004,49768,23978,25790
1104,58104,"Tivoli",2005,50854,24522,26332
1105,58104,"Tivoli",2006,51309,24666,26643
1106,58104,"Tivoli",2007,51847,24983,26864
1107,58104,"Tivoli",2008,52853,25517,27336
1108,58104,"Tivoli",2009,55629,27021,28608
1109,58104,"Tivoli",2010,56275,27358,28917
1110,58104,"Tivoli",2011,56531,27430,29101
1111,58105,"Tolfa",2002,4937,2479,2458
1112,58105,"Tolfa",2003,4985,2504,2481
1113,58105,"Tolfa",2004,5064,2545,2519
1114,58105,"Tolfa",2005,5061,2542,2519
1115,58105,"Tolfa",2006,5072,2559,2513
1116,58105,"Tolfa",2007,5066,2559,2507
1117,58105,"Tolfa",2008,5168,2602,2566
1118,58105,"Tolfa",2009,5236,2633,2603
1119,58105,"Tolfa",2010,5258,2642,2616
1120,58105,"Tolfa",2011,5252,2636,2616
1121,58106,"Torrita Tiberina",2002,935,456,479
1122,58106,"Torrita Tiberina",2003,944,459,485
1123,58106,"Torrita Tiberina",2004,983,488,495
1124,58106,"Torrita Tiberina",2005,1010,503,507
1125,58106,"Torrita Tiberina",2006,1026,511,515
1126,58106,"Torrita Tiberina",2007,1026,517,509
1127,58106,"Torrita Tiberina",2008,1040,516,524
1128,58106,"Torrita Tiberina",2009,1059,517,542
1129,58106,"Torrita Tiberina",2010,1053,522,531
1130,58106,"Torrita Tiberina",2011,1076,531,545
1131,58107,"Trevignano Romano",2002,4610,2205,2405
1132,58107,"Trevignano Romano",2003,4787,2301,2486
1133,58107,"Trevignano Romano",2004,4923,2333,2590
1134,58107,"Trevignano Romano",2005,5078,2406,2672
1135,58107,"Trevignano Romano",2006,5310,2514,2796
1136,58107,"Trevignano Romano",2007,5363,2536,2827
1137,58107,"Trevignano Romano",2008,5701,2711,2990
1138,58107,"Trevignano Romano",2009,5862,2808,3054
1139,58107,"Trevignano Romano",2010,5897,2823,3074
1140,58107,"Trevignano Romano",2011,5949,2821,3128
1141,58108,"Vallepietra",2002,374,187,187
1142,58108,"Vallepietra",2003,372,187,185
1143,58108,"Vallepietra",2004,367,183,184
1144,58108,"Vallepietra",2005,367,182,185
1145,58108,"Vallepietra",2006,345,172,173
1146,58108,"Vallepietra",2007,336,169,167
1147,58108,"Vallepietra",2008,327,162,165
1148,58108,"Vallepietra",2009,325,163,162
1149,58108,"Vallepietra",2010,318,161,157
1150,58108,"Vallepietra",2011,308,156,152
1151,58109,"Vallinfreda",2002,294,150,144
1152,58109,"Vallinfreda",2003,292,153,139
1153,58109,"Vallinfreda",2004,286,149,137
1154,58109,"Vallinfreda",2005,285,146,139
1155,58109,"Vallinfreda",2006,292,148,144
1156,58109,"Vallinfreda",2007,295,154,141
1157,58109,"Vallinfreda",2008,300,153,147
1158,58109,"Vallinfreda",2009,301,150,151
1159,58109,"Vallinfreda",2010,314,153,161
1160,58109,"Vallinfreda",2011,316,157,159
1161,58110,"Valmontone",2002,12224,5933,6291
1162,58110,"Valmontone",2003,12415,6033,6382
1163,58110,"Valmontone",2004,12833,6258,6575
1164,58110,"Valmontone",2005,13453,6602,6851
1165,58110,"Valmontone",2006,13683,6720,6963
1166,58110,"Valmontone",2007,13860,6803,7057
1167,58110,"Valmontone",2008,14447,7138,7309
1168,58110,"Valmontone",2009,14862,7346,7516
1169,58110,"Valmontone",2010,15130,7486,7644
1170,58110,"Valmontone",2011,15469,7654,7815
1171,58111,"Velletri",2002,48266,23459,24807
1172,58111,"Velletri",2003,48908,23767,25141
1173,58111,"Velletri",2004,50036,24370,25666
1174,58111,"Velletri",2005,50324,24487,25837
1175,58111,"Velletri",2006,50699,24678,26021
1176,58111,"Velletri",2007,51021,24837,26184
1177,58111,"Velletri",2008,51507,25069,26438
1178,58111,"Velletri",2009,52647,25676,26971
1179,58111,"Velletri",2010,53054,25870,27184
1180,58111,"Velletri",2011,53544,26127,27417
1181,58112,"Vicovaro",2002,3715,1805,1910
1182,58112,"Vicovaro",2003,3929,1913,2016
1183,58112,"Vicovaro",2004,3935,1903,2032
1184,58112,"Vicovaro",2005,4047,1965,2082
1185,58112,"Vicovaro",2006,4036,1962,2074
1186,58112,"Vicovaro",2007,3952,1919,2033
1187,58112,"Vicovaro",2008,4047,1975,2072
1188,58112,"Vicovaro",2009,4101,2004,2097
1189,58112,"Vicovaro",2010,4123,2020,2103
1190,58112,"Vicovaro",2011,4108,2016,2092
1191,58113,"Vivaro Romano",2002,223,112,111
1192,58113,"Vivaro Romano",2003,226,116,110
1193,58113,"Vivaro Romano",2004,216,110,106
1194,58113,"Vivaro Romano",2005,204,103,101
1195,58113,"Vivaro Romano",2006,211,106,105
1196,58113,"Vivaro Romano",2007,204,100,104
1197,58113,"Vivaro Romano",2008,194,94,100
1198,58113,"Vivaro Romano",2009,194,92,102
1199,58113,"Vivaro Romano",2010,194,92,102
1200,58113,"Vivaro Romano",2011,192,91,101
1201,58114,"Zagarolo",2002,12855,6330,6525
1202,58114,"Zagarolo",2003,13265,6556,6709
1203,58114,"Zagarolo",2004,13866,6867,6999
1204,58114,"Zagarolo",2005,14620,7263,7357
1205,58114,"Zagarolo",2006,15153,7526,7627
1206,58114,"Zagarolo",2007,15435,7712,7723
1207,58114,"Zagarolo",2008,16073,8045,8028
1208,58114,"Zagarolo",2009,16877,8468,8409
1209,58114,"Zagarolo",2010,17328,8700,8628
1210,58114,"Zagarolo",2011,17628,8837,8791
